# wall
+ closeddoor
_ opendoor

#######################################################################################################
#                                                                                                     #
#        #                                                                                            #
#                            +                                                                _       #
#                                                     _                                               #
#         +                                                                                           #
#                                                                   #                                 #
#                                                                                                     #
#                                                                                                     #
#                                               ##_##                                                 #
#                                   #           #   #                                                 #
#                                               #   #                                                 #
#                                               ##+##                                                 #
#                                                                                                     #
#              _                                                                                      #
#                                                                                             +       #
#                                                                                                     #
#                           #                                                                         #
#                                                +                                                    #
#                                                                                      #              #
#                                                                                                     #
#                                                                                                     #
#      +                                                          _                                   #
#                                                                                                     #
#######################################################################################################

